3 1 1 1 1 1 1 1 1 1 1 1 1 1 1 1 1 1 1 1 1 1 1 1 1 1 1 1 1 1 1 1 1 1 1 1 1 1 1 1 1 1 1 1 1 1 1 1 1 1 1 1 1 1 1 1 1 1 1 1 1 1 1 3
3 1 4 4 4 4 4 4 4 4 4 4 4 4 4 4 4 4 4 4 4 4 4 4 4 1 1 1 1 1 1 4 4 4 4 4 4 4 4 4 4 4 4 4 4 4 4 4 4 4 4 4 4 4 4 4 4 4 1 1 1 1 1 3
3 1 4 0 0 0 0 0 0 0 0 0 0 0 0 0 0 0 0 0 0 0 0 0 4 1 1 1 1 1 1 4 0 0 0 0 0 0 0 0 0 0 0 0 0 0 0 0 0 0 0 0 0 0 0 0 0 4 1 1 1 1 1 3
3 1 4 0 0 0 0 0 0 0 0 0 0 0 0 0 0 0 0 0 0 0 0 0 4 1 1 1 1 1 1 4 0 0 0 0 0 0 0 0 0 0 0 0 0 0 0 0 0 0 0 0 0 0 0 0 0 4 1 1 1 1 1 3
3 1 4 0 0 0 0 0 0 0 0 0 0 0 0 0 0 0 0 0 0 0 0 0 4 1 1 1 1 1 1 4 0 0 0 0 0 0 0 0 0 0 0 0 0 0 0 0 0 0 0 0 0 0 0 0 0 4 1 1 1 1 1 3
3 1 4 0 0 0 4 4 4 4 4 4 4 4 4 4 4 4 4 4 4 0 0 0 4 1 1 1 1 1 1 4 0 0 0 4 4 4 4 4 4 4 4 4 4 4 4 4 4 4 4 4 4 4 0 0 0 4 1 1 1 1 1 3
3 1 4 6 6 0 4 1 1 1 1 1 1 1 1 1 1 1 1 1 4 0 0 0 4 1 1 1 1 1 1 4 0 6 6 4 1 1 1 1 1 1 1 1 1 1 1 1 1 1 1 1 1 4 6 6 0 4 1 1 1 1 1 3
3 1 4 0 0 0 4 1 1 1 1 1 1 1 1 1 1 1 1 1 4 0 0 0 4 1 1 1 1 1 1 4 0 0 0 4 4 4 4 4 4 4 4 4 4 4 1 1 1 1 1 1 1 4 0 0 0 4 1 1 1 1 1 3
3 1 4 0 0 0 4 1 1 1 1 1 1 1 1 1 1 1 1 1 4 0 0 0 4 1 1 1 1 1 1 4 0 0 0 0 0 0 0 0 0 0 0 0 0 4 1 1 1 1 1 1 1 4 0 0 0 4 1 1 1 1 1 3
3 1 4 0 0 0 4 1 1 1 1 1 1 1 1 1 1 1 1 1 4 0 0 0 4 1 1 1 1 1 1 4 0 0 0 0 0 0 0 0 0 0 0 0 0 4 1 1 1 1 1 1 1 4 0 0 0 4 1 1 1 1 1 3
3 1 4 0 0 0 4 1 1 1 1 1 1 1 1 1 1 1 1 1 4 0 0 0 4 1 1 1 1 1 1 4 0 0 0 0 0 0 0 0 0 0 0 0 0 4 1 1 1 1 1 1 1 4 0 0 0 4 1 1 1 1 1 3
3 1 4 0 0 0 4 1 1 1 1 1 1 1 1 1 1 1 1 1 4 0 0 0 4 1 1 1 1 1 1 4 4 4 4 4 4 4 4 4 4 4 0 0 0 4 1 1 1 1 1 1 1 4 0 6 6 4 1 1 1 1 1 3
3 1 4 0 0 0 4 1 1 1 1 1 1 1 1 1 1 1 1 1 4 0 0 0 4 1 1 1 1 1 1 1 1 1 1 1 1 1 1 1 1 4 0 0 0 4 1 1 1 1 1 1 1 4 0 0 0 4 1 1 1 1 1 3
3 1 4 0 0 0 4 1 1 1 1 1 1 1 1 1 1 1 1 1 4 0 0 0 4 4 4 4 4 4 4 4 4 4 4 4 4 4 4 4 4 4 0 0 0 4 1 1 1 1 1 1 1 4 0 0 0 4 1 1 1 1 1 3
3 1 4 5 5 5 4 1 1 1 1 1 1 1 1 1 1 1 1 1 4 0 0 0 0 0 0 0 0 0 0 0 0 0 0 0 0 0 0 0 0 0 0 0 0 4 1 1 1 1 1 1 1 4 0 0 0 4 1 1 1 1 1 3
3 1 4 5 5 5 4 1 1 1 1 1 1 1 1 1 1 1 1 1 4 0 0 0 0 0 0 0 0 0 0 0 0 0 0 0 0 0 0 0 0 0 0 0 0 4 1 1 1 1 1 1 1 4 0 0 0 4 1 1 1 1 1 3
3 1 4 0 0 0 4 1 1 1 1 1 1 1 1 1 1 1 1 1 4 0 0 0 0 0 0 0 0 0 0 0 0 0 0 0 0 0 0 0 0 0 0 0 0 4 1 1 1 1 1 1 1 4 6 6 0 4 1 1 1 1 1 3
3 1 4 0 0 0 4 1 1 1 1 1 1 1 1 1 1 1 1 1 4 4 4 4 4 4 4 4 4 4 4 4 4 4 4 4 4 4 4 4 4 4 4 4 4 4 1 1 1 1 1 1 1 4 0 0 0 4 1 1 1 1 1 3
3 1 4 0 0 0 4 1 1 1 1 1 1 1 1 1 1 1 1 1 1 1 1 1 1 1 1 1 1 1 1 1 1 1 1 1 1 1 1 1 1 1 1 1 1 1 1 1 1 1 1 1 1 4 0 0 0 4 1 1 1 1 1 3
3 1 4 0 0 0 4 1 1 1 1 1 1 1 1 1 1 1 1 1 1 1 1 1 1 1 1 1 1 1 1 1 1 1 1 1 1 1 1 1 1 1 1 1 1 1 1 1 1 1 1 1 1 4 0 0 0 4 1 1 1 1 1 3
3 1 4 0 0 0 4 1 1 1 1 1 1 1 1 1 1 1 1 1 1 1 1 1 1 1 1 1 1 1 1 1 1 1 1 1 1 1 1 1 1 1 1 1 1 1 1 1 1 1 1 1 1 4 0 0 0 4 1 1 1 1 1 3
3 1 4 0 0 0 4 1 1 1 1 1 1 1 1 1 1 1 1 1 1 1 1 1 1 1 1 1 1 1 1 1 1 1 1 1 1 1 1 1 1 1 1 1 1 1 1 1 1 1 1 1 1 4 0 6 6 4 1 1 1 1 1 3
3 1 4 0 0 0 4 1 1 1 1 1 1 1 1 1 1 1 1 1 1 1 1 1 1 1 1 1 1 1 1 1 1 1 1 1 1 1 1 1 1 1 1 1 1 1 1 1 1 1 1 1 1 4 0 0 0 4 1 1 1 1 1 3
3 1 4 0 0 0 4 1 1 1 1 1 1 1 1 1 1 1 1 1 1 1 1 1 1 1 1 1 1 1 1 1 1 1 1 1 1 1 1 1 1 1 1 1 1 1 1 1 1 1 1 1 1 4 0 0 0 4 1 1 1 1 1 3
3 1 4 0 0 0 4 1 1 1 1 1 1 1 1 4 4 4 4 4 4 4 4 4 4 4 4 4 4 4 4 4 4 4 4 4 4 4 4 4 4 4 1 1 1 1 1 1 1 1 1 1 1 4 0 0 0 4 1 1 1 1 1 3
3 1 4 0 6 6 4 1 1 1 1 1 1 1 1 4 0 0 0 0 0 0 0 0 0 0 0 0 0 0 0 0 0 0 0 0 0 0 0 0 0 4 1 1 1 1 1 1 1 1 1 1 1 4 0 0 0 4 1 1 1 1 1 3
3 1 4 0 0 0 4 1 1 1 1 1 1 1 1 4 0 0 0 0 0 0 0 0 0 0 0 0 0 0 0 0 0 0 0 0 0 0 0 0 0 4 1 1 1 1 1 1 1 1 1 1 1 4 6 6 0 4 1 1 1 1 1 3
3 1 4 0 0 0 4 1 1 1 1 1 1 1 1 4 0 0 0 0 0 0 0 0 0 0 0 0 0 0 0 0 0 0 0 0 0 0 0 0 0 4 1 1 1 1 1 1 1 1 1 1 1 4 0 0 0 4 1 1 1 1 1 3
3 1 4 0 0 0 4 1 1 1 1 1 1 1 1 4 0 0 0 4 4 4 4 4 4 4 4 4 4 4 4 4 4 4 4 4 4 0 0 0 0 4 1 1 1 1 1 1 1 1 1 1 1 4 0 0 0 4 1 1 1 1 1 3
3 1 4 0 0 0 4 4 4 4 4 4 4 4 4 4 0 0 0 4 4 4 4 4 4 4 4 4 4 4 4 4 4 4 4 4 4 4 4 0 0 0 0 4 4 4 4 4 4 4 4 4 4 4 0 0 0 4 1 1 1 1 1 3
3 1 4 0 0 0 0 0 0 0 0 0 0 0 0 0 0 0 0 0 0 0 0 0 0 0 0 0 0 0 0 0 0 0 0 0 0 0 0 0 0 0 0 0 0 0 0 0 0 0 0 0 0 0 0 0 0 4 1 1 1 1 1 3
3 1 4 0 0 0 0 0 0 0 0 0 0 0 0 0 0 0 0 0 0 0 0 0 0 0 0 0 0 0 0 0 0 0 0 0 0 0 0 0 0 0 0 0 0 0 0 0 0 0 0 0 0 0 0 0 0 4 1 1 1 1 1 3
3 1 4 0 0 0 0 0 0 0 0 0 0 0 0 0 0 0 0 0 0 0 0 0 0 0 0 0 0 0 0 0 0 0 0 0 0 0 0 0 0 0 0 0 0 0 0 0 0 0 0 0 0 0 0 0 0 4 1 1 1 1 1 3
3 1 4 4 4 4 4 4 4 4 4 4 4 4 4 4 4 4 4 4 4 4 4 4 4 4 4 4 4 4 4 4 4 4 4 4 4 4 4 4 4 4 4 4 4 4 4 4 4 4 4 4 4 4 4 4 4 4 1 1 1 1 1 3
3 1 1 1 1 1 1 1 1 1 1 1 1 1 1 1 1 1 1 1 1 1 1 1 1 1 1 1 1 1 1 1 1 1 1 1 1 1 1 1 1 1 1 1 1 1 1 1 1 1 1 1 1 1 1 1 1 1 1 1 1 1 1 3
